WWWWWWWWWWWWWWWWWWWWWWWWWWWWWWWWWW
W                POOO            W   
W   UUUUUUUUU                    W        
W   UUUUUUUUU          CCCCCC    WWWW   
W   UUUUUUUUU          CCCCCC       W
W                      CCCCCC       W
W     WWWWWWWWWWWWWWWWWWWWWWWWWWWWWWW
W                                   W
W                                   W
W                                   W
W         PPPPPPP                   W
W         PPPPPPP                   W
W         PPPPPPP                   W
W                       CCCC        W
W                       CCCC        W
WWWWWWWWWWWWWWWWWWWWWWWWWWWWWWWWWWWWW
