     WWWWWWWWWWWWWWWWWWWWWWWWWWWWWWWWWWWWWWWWWWWWWWWWWWWWWWWWWWWWWWWWWWWWWWWWWWWWWWWWWWWWWWWWWWWWWWWWWWWWWWWWWWWWWWWWWWWWWWWWWWWWWWWWWWWWWWWWWWWWWWWWWWWWWWWWWWWWWWWWWWWWWWWWWWWWWWWWWWWWWWWWWWWWWWWWWWWWWWWWWWWWWWWWWWWWWWWWWWWWWWWWWWWWWWWWWWWWWWWWWWWWWWWWWWWWWWWWWWWWWWWWWWWWWWWWWWWWWWWWWWWW
     W            W W                                                                                                                 W                                                                                                     W                                           OOOOOOO W
WWWWWWWW                                                                                                                              W                                                                 UUUUUUUUUUUUUUUUUUUUUUUUUUUU        W                                                 O WWWW
W           P      UUPUPPUUP          UPUUPUUPUUPUUPUU                                                                                W               WWWWWWWWWWWWWWWWWWWWWWWWWWWWWWWWWWWWWWWWWWW                                           W                                                   WWWWWWWWWWWWWWWWWWWW
W  UUUUUUUUUUU     WWWWWWWWWWWWWWWWW                                                                                                  W                                                                                                 W   W                                                                      W
W                  WWWWWWWWWWWWWWWWW          WWWWWWWWWWWWWWWWW                                                                       W      PUPUPP                                                                                         W                                                                      W
W                  WWWWWWWWWWWWWWWWW UPUUPUUPUUPUUPUUPUUPUUPUUPUUPUUPUUPUUPU                                                          W                                                                                                     W                                                                      W
WU          PPPPPPPWWWWWWWWWWWWWWWWW                UUUUUUUUPPPPUPPUPUU                                                               W                                                WWWWWWWWWWWWWWWWWWWWWWWWWWWW                         W                                                                      W
W           PPPPPPPWWWWWWWWWWWWWWWWW                  PUUPUPUUUP                                                                      W      WWWWWWWWWWWWWWWWWWWWWWW                                           PPPUPUUUUP                   W                                                 WWWWWWWWWWWWWWWWWWWWWW
W           PPPPPPPWWWWWWWWWWWWWWWWW              WWWWWWWWWWWWWWWWW    UUUUU                                                          W                                                                                                     W                                                 W          W         W
W          PPPPPPPPWWWWWWWWWWWWWWWWW     UUUUUUUUUUUUUUUUUUUU           WW U                                                          W               PUPUUPU                                                                               W                                                 W                    W
WWW                WWWWWWWWWWWWWWWWW                                    WOOO                                                          W                                                        WWWWWWWWWWWWWWWWWWWWWWWWWWWWWWWWW            W                                                            W         W
WOO W                                 UUUUUUUUUUUUUU         PPPPPPPPPP                                                               W        WWWWWWWWWWWWWWWWWWWWWWWWWWWWWWWWWWWWWW                                                       W                                                 W          W         W
WWW            O              O              UUUUUUUUUU                                                                               W                                                                                                     W                                                 W          W         W
W                                                                                                                                     W                                                                                                     W                                                 WWWWWWWWWWWWWWWWWWWWWW
W                                                                                                                                     W                                                                                                     W                                                 W          W         W
W                WWW                                                                                                                  WWWWWWWWWWWWWWWWWWWWWWWWWWWWWWWWWWWWW                              WWWWWWWWWWWWWWWWWWWWWWWWWWWWWWWWWWWW                                                 W          W  UUUU   W
W                WWW                                                                                                                                                                                                                                                                          W          W         W
W                WWW                                                                                                                                                                                                                                                                          W                    W
WWWWWWWW         WWW               WWW                                                                                                                                                                                                                                                                   W         W
W      W         WWW               WWW                                                                                                                                                                                                                                                        W          W         W
W      W         WWW               WWW                                                                                                                                                                                                                                                        WWWWWWWWWWWWWWWWWWWWWW
W      W         WWW               WWW                                                                                                                                                                                                                                                        W          W   PPP   W
W                WWW               WWW                                                                                                                                                                                                                                                        W                    W
W      W         WWW               WWW                                                                                        PUUPUUPUUPU                                                                                                                                                                W         W
WWWWWWWW         WWWWWWWW                                                                                                                                                                                                                                                                     WWWWWWWWWWWWWWWWWWWWWW
W      W                                                                     PUUPUUPUUPU                                                                                                                                                                                                      W          W         W
W      W                                                                                                                                                                                                                                                                                      W          W         W
W      W                                                                                                                                                                                     PUUPUUPUUPU                                                                                                 W         W
W      W                                                                                                                          PUUPUUPUUPU                                                                                                                                                 W          W         W
W      W                                                                                                                                                                                                                                                                                      W                    W
W      W                                                                                                                                                                                                                                                                                      W UUUUUU   W         W
W                                                                                                                                                                                                                                                                                             WWWWWWWWWWWWWWWWWWWWWW
W      W                                                                                                                                                                     PUUPUUPUUPU                                                                                                      W                    W
W      W                                                                                                                                                                                                                                                                                      W                    W
WWWWWWWW                                              PUUPUUPUUPU                                                                                                                                                                                                                                                  W
W      W                                                                                                                                                                                                                                                                                      W          W         W
W                                                                                                                                    PUUPUUPUUPU                                                 PUUPUUPUUPU                                                                                  WWWWWWWWWWWWWWWWWWWWWW
W      W                                                                                                                                                                                                                                                                                                 W         W
W      W                                                                                                                                                                                                                                                                                      W          W PUUPP   W
W      W                                                                                                                                                                                                                                                                                      W          W         W
W      W                                                                                                                                                                                                                                                                                      W          W         W
W      W                                                                                                                                                PUUPUUPUUPU                                                                                                                           W          W         W
W      W                                                                                                                                                                                                                                                                                      W          W         W
W      W                                                                                                                                                                                                                                                                                      W          W         W
W      W                                                                                             WWWWWWWWWWWWWWWWWWWWWWWWWWWWWWWWWWWWWWWWWWWWWWWWWWWWWWWWWWWWWWWWWWWWWWWWWWWWWWWWWWWWWWWWWWWWWWWWWWWWWWWWWWWWW                                                                            W                    W
W      W                                                                                             WWWWWWWWWWWWWWWWWWWWWWWWWWWWWWWWWWWWWWWWWWWWWWWWWWWWWWWWWWWWWWWWWWWWWWWWWWWWWWWWWWWWWWWWWWWWWWWWWWWWWWWWWWWWW                                                                            W PPPPP    W         W
WWWWWWWWWWWWWWWWWWWWWWWWWWWWWWWWWWWWWWWWWWWWWWWWWWWWWWWW                                             WWWWWWWWWWWWWWWWWWWWWWWWWWWWWWWWWWWWWWWWWWWWWWWWWWWWWWWWWWWWWWWWWWWWWWWWWWWWWWWWWWWWWWWWWWWWWWWWWWWWWWWWWWWWW                                                                            W          W         W
W                                                                                                    WWWWWWWWWWWWWWWWWWWWWWWWWWWWWWWWWWWWWWWWWWWWWWWWWWWWWWWWWWWWWWWWWWWWWWWWWWWWWWWWWWWWWWWWWWWWWWWWWWWWWWWWWWWWW                                                                            WWWWWWWWWWWWWWWWWWWWWW
W                                                                                                               PUUPUUPUUPUUPUP      PPPPP                                                                                                                                                    W                    W
W   WWWWWWWWWWWWWWWWWWWWWWWWW   WWWWWWWWWW   WWWWWWWWWWW                                             WWWWWWWWWWWWWWWWWWWWWWWWWWWWWWWWWWWWWWWWWWWWWWWW          WWWWWWWWWWWWWWWWWWWWWWWWWWWWWWWWWWWWWWWWWWWWWWWWWWW                                                                            W    PUUPUUPUUPU     W
W          W                       W                   W                                             WWWWWWWWWWWWWWWWWWWWWWWWWWWWWWWWWWWWWWWWWWWWWWWW      PPPPWWWWWWWWWWWWWWWWWWWWWWWWWWWWWWWWWWWWWWWWWWWWWWWWWWW                                                                            W                    W
W          W                       W                   W                                             WWWWWWWWWWWWWWWWWWWWWWWWWWWWWWWWWWWWWWWWWWWWWWWW          WWWWWWWWWWWWWWWWWWWWWWWWWWWWWWWWWWWWWWWWWWWWWWWWWWW                                                                            W                    W
W      PUUUW                       W                   W                                             WWWWWWWWWWWWWWWWWWWWWWWWWWWWWWWWWWWWWWWWWWWWWWWW          WWWWWWWWWWWWWWWWWWWWWWWWWWWWWWWWWWWWWWWWWWWWWWWWWWW                                                                                                 W
W          W     PUUPUUPUUPU       W                   W                                             WWWWWWWWWWWWWWWWWWWWWWWWWWWWWWWWWWWWWWWWWWWWWWWW          WWWWWWWWWWWWWWWWWWWWWWWWWWWWWWWWWWWWWWWWWWWWWWWWWWW                                                                            W                    W
W          W                       W                   W                                                                                                                                                                                                                                      W                    W
W          W                       W UPUPUUPU          W                                                                                                                                                                                                                                      W                    W
W          W                       W                   W                                                                                                                                                                                                                                      W                    W
W          W                       W                   W                                                                                                                                                                                                                                      W                    W
WWWWWWWWWWWWWWWWWWWWWWWWWWWWWWWWWWWWWWWWWWWWWWWWWWWWWWWW                                                                                                                                                                                                                                      W                    W
W                                                                                                                                                                                                                                                                                             WWWWWWWWWWWWWWWWWWWWWW
W                                                                                                                                                                                                                                                                                                                  W
W                                                                                                                                                                                                                                                                                                                  W
W                                                                                                                                                                                                                                                                                                                  W
W                                                                                                                                                                                                                                                                                                                  W
W                                                                                                                                                                                                                                                                                                                  W
W                                                                                                                                                                                                                                                                                                                  W
W                                                                                                                                                                                                                                                                                                                  W
W                                                                                                                                                                                                                                                                                                                  W
W                                                                                                                                                                                                                                                                                                     W            W
W                                                                                                                                                                                                                                                                                                     W            W
W                                                                                                                                                                                                                                                                                                     W            W
W                                                                                                                                                                                                                                                                                                     W            W
W OOOOOOO                                                                                                                                                                                                                                                                                             WOOOOOOOOOOOOW
WWWWWWWWWWWWWWWWWWWWWWWWWWWWWWWWWWWWWWWWWWWWWWWWWWWWWWWWWWWWWWWWWWWWWWWWWWWWWWWWWWWWWWWWWWWWWWWWWWWWWWWWWWWWWWWWWWWWWWWWWWWWWWWWWWWWWWWWWWWWWWWWWWWWWWWWWWWWWWWWWWWWWWWWWWWWWWWWWWWWWWWWWWWWWWWWWWWWWWWWWWWWWWWWWWWWWWWWWWWWWWWWWWWWWWWWWWWWWWWWWWWWWWWWWWWWWWWWWWWWWWWWWWWWWWWWWWWWWWWWWWWWWWWWWWWWWWWWWWWWWWWWWWWW