       WWWWWWWWWWWWWWWWWWWWWWWWWWWWWWWWWWWWWWWWWWWWWWWWWWWWWWWWWWWWWWWWWWWWWWWWWWWWWWWWWWWWWWWWWWWWWWWWWWWWWWWWWWWW
       WWWWWWWWWWWWWWWWWWWWWWWWWWWWWWWWWWWWWWWWWWWWWWWWWWWWWWWWWWWWWWWWWWWWWWWWWWWWWWWWWWWWWWWWWWWWWWWWWWWWWWWWWWWW
       WWO           C     PPPPP                   UUU         C            P      PPP      CCCCC               OWW
       WWWWWWWW        WWWWWWWWWWWWWWWWWWWWWWWWWWW  W            WWWWWWWWWWWWWWWWWWWWWWWWWWW           WWWWWWWWWWWW
       WWWWWWWW        W     PPPP W     PPPP        W            W             W           W           W   PCP  OWW
       WWWWWWWW  PPP   W  WWW     W    WWWWWWWWWW   W            W     UUUUUU  W   PPPPPPP W     C     WW  WWWWWWWW
       WWWWWWWW        W          W                              W WWWWWWW     W      WWWWWW                WP   WW
       WWWWWWWW        W  WWWW    W     UU    UUU                W             W           WU  UU      W         WW
       WWWWWWWW  UUU              W   WWWWWWWWWW    W     W                    W              C        W   WWWWWWWW
       WWWWWWWW        W   CPUPUU W                 W     W      W  PPPP       W                       W   PCCC  WW
       WWWWWWWW        W  WWWWW   W                 W            W       WWWWW W  WWWWWWW  W  C        WWWWWWWWWWWW
      WWWWWWW        WW           W    WWWWWWWWW    W        C   WWWWWWWW      W           W           W         WW
     WWWWWWW        W             W     CPCP        W        P   W    CCCCPPP  W   CPPP    W    CCC    W  PPPP   WW
    WWWWWWW CCC    W    WWWWWWWW  WWWWWWWWWWWWWWWWWWW            WWWWWWWWWWWWWWWWWWWWWWWWWWW                     WW
    WWWWW          W       CPUC   W     CPUCPU      W            W   CCCUUU    W           W           W         WW
    WWWW           WWWWWWWWWWWWWWWW                 W     W      W   WWWWWWW   W   WWWWW   W    P PP   WWWWWW    WW
    WWWWWWWWW        W  UU        W   WWWWWWWWW     W     W  CC  W   W         W  CCCCCC   W           W         WW
    WWWPPPP W        W        P   W                 W     W      W       CCCC  W           W           W CCC     WW
    WWW   W W        W   WWWWWWW  W   W             W            WWWWWWW       W   PPPPP   W           WWWWWWWWWWWW
    WWW                           W P WCUCU                  U                 W                       W  CCCC   WW
    WWW WW  W   PP   W   WWWWWWW  W   W                          W             W           W           W         WW
    WWW     W        W      C     W       WWWWWWWWWWW            W       PP    W WWWWWW    W                     WW
    WWW PCUWW        W   WWWWWWW  W                 W        U   WWWWWWWWW     W           W           W         WW
    WWWWWWWWW        W            WWWWWWWW          W            W             W   WWWW    W   PPPP    W  WWWW   WW
    WWW     W        WCC   CPUCPU W      CPUCPU     W        U   W   CPUUCCP   W   PPPP    W           W  CPUCP  WW
    WWW CC  W        WWWWWWWWWWWWWWWWWWWWWWWWWWWWWWWW            WWWWWWWWWWWWWWWWWWWWWWWWWWW           WWWWWWWWWWWW
    WWW     W                                                                                                    WW
    WWW P                                   C     P P   P  U U C  U P                                            WW
     WWWWWWWW W    WWWWWWWWWWWWWWW   WWWWWWWWWWWWWWWWWWWWWWWWWWWWW  WWWWWWWWWWWWWWWWWW WWWWWWWWWWW  WWWWWWWW     WW
      WWWP    W    WCP  W     C             W  CPUUUP  W PPPPP           W    CPUC W  C          W    CC   W     WW
       WWW    W    W    W     P             W          W WWWWWW      WWWWWPUC PUC  W       WWWW PW  WWWW   W     WW
        WWW C W    W    W     WWWW   WWWWWWWWWWWW      WWWWW     WWW     WWWWWWWW   P   WW  PUPU W         W     WW
         WWWWWWOOOOW U        PP           CPUCPUC     W CCCC    PP      W              PP   WWWWW  PW        WOOWW
          WWWWWWWWWWWWWWWWWWWWWWWWWWWWWWWWWWWWWWWWWWWWWWWWWWWWWWWWWWWWWWWWWWWWWWWWWWWWWWWWWWWWWWWWWWWWWWWWWWWWWWWWW
          WWWWWWWWWWWWWWWWWWWWWWWWWWWWWWWWWWWWWWWWWWWWWWWWWWWWWWWWWWWWWWWWWWWWWWWWWWWWWWWWWWWWWWWWWWWWWWWWWWWWWWWWW